
NO ./texture/redbrick.xpm

SO ./texture/lava01.xpm

EA ./texture/graystone.xpm

WE ./texture/Roger.xpm
F 220,100,0
C 225,30,0

111111111111111111111111111111111
110000000000000011111111111111111
111000000011000001110000000000000111111
111001000000000000000000001101111
11111111111011000001110000000001
11000000000110000011101111111111111111
111110111111111011100000010001111
1111101111111110111010100100011
1110000001101010111000000100011
110000000000000011000000100011111
110000000000S00001101010010001111
111000001110001011111011110001111
111110100000000000000101000111
111111111111111111111111111111