SO ./path_to_the_south_texture.xpm
WE ./path_to_the_west_texture.xpm
EA ./path_to_the_east_texture.xpm
NO ./path_to_the_north_texture.xpm
F 220,100,0
C 225,30,0

111111111111111111111111111111111
110000000000111111111111111111
111000110000011100000000000001111
111001000000000000000000001101111
1111111111101100N0001110000000001
110000000001100000111011111111111
111110111111111011100000010001111
1111101111111110111010100100011
1110000001101010111000000100011
110000000000000011000000100011111
110000000000000001101010010001111
111000001110101011111011110001111
111110100000000000000101000111
111111111111111111111111111111