SO ./path_to_the_south_texture.xpm
WE ./path_to_the_west_texture.xpm
EA ./path_to_the_east_texture.xpm
NO ./path_to_the_north_texture.xpm
F 220,100,0
C 225,30,0

111111111111111111111111111111111
101111111111101111111111111111111
110001100000111000000000000011111
110010000000000000000000011011111
111111111101100N00011100000000001
100000000011000001110111111111111
111101111111110111000000100011111
111101111111110111010100100011111
110000001101010111000000100011111
100000000000000110000001000111111
100000000000000011010100100011111
110000011101010111110111100011111
111101111110101101111010001111111
111111111111111111111111111111111