NO ./texture/BRICK_4A.xpm
EA ./texture/graystone.xpm
WE                            ./texture/lava04.xpm
F       220,100,50
C       225,30,0
SO ./texture/colorstone.xpm

                  111
              1111000111
              1000000001
              1001111011
              1000001001
              1000001101
              1000001001
              1000111011
              1000100001
        111111111110011111111111
        10000010000110000000000011111111
        101101110111100100000000000000001
        100100100000000000000000111111111
111111111011000001110000000000001
100000000011000001110111111111111                             11111111111
11110111111111000000000010001                                 10000000001
11110111111111011101010010001                                 10000000001
11000000110101011100000010001                                 10000000000111111
1000000000000000011000000100011111111111111111111111111111111111000000000000001
1000000000N00000110101000000000000000000000000000000000000000000000000000000001
1000000000000000110101000000000000000000000000000000000000000000000000000000001
1100000111010101111101111000111111111111111111111111111111111111111111110000001
10000111111111111111111111111                                          10000001
10001111111111111111111111111                                          11111111
1001
1001
1111