NO ./path_to_the_north_texture.xpm
SO ./path_to_the_south_texture.xpm
WE ./path_to_the_west_texture.xpm
EA ./path_to_the_east_texture.xpm

F 220,100,0
C 225,30,0


111111111111111111111111111
111111110000000001100000000111
1100000000000001100000000000011
11111111101100000111000000000001
111110010000000000000000000011111
111111111011000001110000000000001
100000000011000001110111111111111
11110111111111011100000010001
11110111111111011101010010001
11000000110101011100000010001
1000000000000001100000010001
10000000000000001101010010001
1100000110101011111011110N0111
1111011101110101101111010001
111111111111111111111111111
